11111111100000000000000000000000000000000000000000
11111111100000111111111111111111111111111111111000
00000000000000000000000000000000000000000000011000
00000001111111111111111000000000000000000000011000
00000001111111111111111000000011111111111111011000
00000000000000000000011000000011111111111111011000
00011111111111110000011111110010000000001101011000
00011111111111110000011111110010000000001101011000
00011000000000110000000000110011111111101101011000
00011000000000110011111111110011111111101101011000
00011000000000110011111111110000000001101101011000
00011000000000110011000000000000000001101101011000
11111000000000110011000000000000000001101101011000
00000000000000110011000000000111111101101101011000
00000011111100110011111111000000001101101101011000
00000011111100110011111111011000001101101101011000
00000010001100110000000011011111101100101101011110
00000010001100111111100011011111100100101101011110
00000010001100111111100011011001100100101101000110
11111010001100000000100011011001100100101101000110
11111010001100000000100011011001100100101101000110
11111010001100000000100011011001100100101101000110
11111010001100000000100011011001100100101101000110
11111010001100000000100011011001100100101101000110 
11111010001100000000100011011001100100101101011110
11111010001100000000100011011010000000110011010000
11111010001100000000100011011010011111110011010000
11111010001100000000100011011010000000000011010000
11111010001100000000111111011011111111111111010000
11111010001100000000111111011011111111111111111111
11111010001100000000000000000000000000000000000001
11111010001100000000000000000000000000000000000001